XXXXXXXXXXXXXXXXXXXXXXXXX
XPOOOOXOOOOOOOOOOOOOOXOOX
XOOOOOXOOOOOOOOOOOOOOXOOX
XOOOOOXOOOOOOOOOOOOOOXOOX
XOOOOOXOOOOOOOOOOOOOOXOOX
XOOOOOXOOOOOOOOOOOOOOXOOX
XOOOOOXOOOOOOOOOOOOOOXOOX
XOOOOOOOOOOOOOOOOOXOOXOOX
XXXXXXXXXXXXXXXXXXXOOOOOX
XXXXXXXXXXXXXXXXXXXXXXXXX