XXXXXXXXXXXXXXXXXXXXXXXXX
XPOOOOXOOOOOOOOOOOOOOXOOX
XOOOOOXOOOOOODOOOOOOOXOOX
XOOOOOXOOOOOODOOOOOOOXOOX
XOOOOOXOOOOCODOOOOOOOXOOX
XOOOOOXOOOOOODOOOOOOOXOOX
XOOOOOXOOOOOODOOOOOOOXOOX
XOOOOOOOOOOOOOOOOOXOOXOOX
XXXXXXXXXXXXXXXXXXXOOOOOX
XXXXXXXXXXXXXXXXXXXXXXXXX